33333333333333333333333333333333333333333333333333333333333333333333333333333333333333333333333333333333333333333333333333333333333333333333333333333333333333333333333333333333333333333333333333333333
3......................................................................................................................................................................................................3
3......................................................................................................................................................................................................3
3......................................................................................................................................................................................................3
3......................................................................................................................................................................................................3
3...........................................................................................................g...............g....g.....................................................................3
3...........................................................................................g..........................................................................................................3
3......................................................................................................................................................................................................3
3......................................................................................................................................................................................................3
3......................................................................................................................................................................................................3
3...................................................................................................................................g..................................................................3
3.................................................................g....................................................................................................................................3
3......................................................................................................................................................................................................3
3.................................@.....................................................................................................................................................................
3......................................................................g......................................................................................................................g.........
3.................................................................................111111111111111111111111..............................................................................................
3.................................................................................4......................4..............................................................................................
3.................................................................................4......................4..............................................................................................
3.................................................................u...............4......................4..............................................................................................
3.................................................................D...............4......................4..............................................................................................
3................................7777777.................g........D....u..........4......................4..........................qq..............................................g...................
3.................................................................D....D..........4......................4..........................LR..................................................................
3..........s.........s............................................D....D..........4......................4..........................LR.......g..........................................................
3.........1277777777721..........quuuuuu........g.................D....D..........4...g..............g...4..........................LR..................................................................
3.g....g..6...........6..g...g...lhhhhhl..........................D....D..........4......................4..........................LR........................................................d.........
3.........6...........6....................................s..7777D....D..........4......................4..........................LR..........................................d.......................
3.........6...........6.................................s22222....D....D..........4......................4...........ss.............LR...........................................................g......
3.........6...........6..............................s222ddd.....227777D..........4......................4...........22.............LR.......................................d......d...................
3.........6...........6...........................s222dddddd...........D..........4......................4...........22.............LR..................................................................
3.........1ss.......ss1..........g.g.g.g........222ddddddddd..........227777..ss..4........ssssss........4..........s22s............LR...ss.......................ss.....................s..............
322222222222277777772222222222222222222222222222dddddddddddd..................11..1111111111111111111111112222222222222222222222222222444447777777777777777777777744444444...............d..............
3.......................................................................................................................................................................................................
3.......................................................................................................................................................................................................
3.......................................................................................................................................................................................................
3..............................................................................................................................................................................s........ssssssss......s.
3..............................................................................................................................................................................7777777777777777777777777
3......................................................................................................................................................................................................3
3......................................................................................................................................................................................................3
3......................................................................................................................................................................................................3
1......................................................................................................................................................................................................1
